Wins - A: 2 | B: 1
Days: 7   Record: 14


┌─────┬─────┬─────┬─────┬─────┐
│  A  │  A  │  B  │  B  │  B  │
├─────┼─────┼─────┼─────┼─────┤
│  A  │  A  │  B  │  B  │  B  │
├─────┼─────┼─────┼─────┼─────┤
│  A  │  A  │  B  │  B  │  B  │
├─────┼─────┼─────┼─────┼─────┤
│  A  │  B  │  B  │  B  │  B  │
├─────┼─────┼─────┼─────┼─────┤
│  A  │  B  │  B  │  B  │  B  │
├─────┼─────┼─────┼─────┼─────┤
│  A  │  A  │  B  │  B  │  B  │
└─────┴─────┴─────┴─────┴─────┘