Wins - A: 0 | B: 0
Days: 3   Record: 3


┌─────┬─────┬─────┬─────┬─────┐
│  A  │  A  │  B  │  B  │  B  │
├─────┼─────┼─────┼─────┼─────┤
│  A  │  A  │  A  │  A  │  B  │
├─────┼─────┼─────┼─────┼─────┤
│  A  │  A  │  A  │  B  │  B  │
├─────┼─────┼─────┼─────┼─────┤
│  A  │  A  │  B  │  B  │  B  │
├─────┼─────┼─────┼─────┼─────┤
│  A  │  A  │  B  │  B  │  B  │
├─────┼─────┼─────┼─────┼─────┤
│  A  │  B  │  B  │  B  │  B  │
└─────┴─────┴─────┴─────┴─────┘