Wins - A: 1 | B: 1
Days: 7   Record: 12


┌─────┬─────┬─────┬─────┬─────┐
│  A  │  A  │  A  │  A  │  B  │
├─────┼─────┼─────┼─────┼─────┤
│  A  │  A  │  A  │  A  │  B  │
├─────┼─────┼─────┼─────┼─────┤
│  A  │  A  │  A  │  B  │  B  │
├─────┼─────┼─────┼─────┼─────┤
│  A  │  A  │  A  │  A  │  B  │
├─────┼─────┼─────┼─────┼─────┤
│  A  │  B  │  B  │  B  │  B  │
├─────┼─────┼─────┼─────┼─────┤
│  A  │  A  │  B  │  B  │  B  │
└─────┴─────┴─────┴─────┴─────┘