Wins - A: 0 | B: 1
Days: 3   Record: 12


┌─────┬─────┬─────┬─────┬─────┐
│  A  │  A  │  A  │  A  │  B  │
├─────┼─────┼─────┼─────┼─────┤
│  A  │  A  │  B  │  B  │  B  │
├─────┼─────┼─────┼─────┼─────┤
│  A  │  A  │  A  │  B  │  B  │
├─────┼─────┼─────┼─────┼─────┤
│  A  │  A  │  B  │  B  │  B  │
├─────┼─────┼─────┼─────┼─────┤
│  A  │  A  │  B  │  B  │  B  │
├─────┼─────┼─────┼─────┼─────┤
│  A  │  B  │  B  │  B  │  B  │
└─────┴─────┴─────┴─────┴─────┘