Wins - A: 2 | B: 1
Days: 2   Record: 14


┌─────┬─────┬─────┬─────┬─────┐
│  A  │  A  │  A  │  B  │  B  │
├─────┼─────┼─────┼─────┼─────┤
│  A  │  A  │  A  │  B  │  B  │
├─────┼─────┼─────┼─────┼─────┤
│  A  │  A  │  A  │  B  │  B  │
├─────┼─────┼─────┼─────┼─────┤
│  A  │  B  │  B  │  B  │  B  │
├─────┼─────┼─────┼─────┼─────┤
│  A  │  B  │  B  │  B  │  B  │
├─────┼─────┼─────┼─────┼─────┤
│  A  │  A  │  B  │  B  │  B  │
└─────┴─────┴─────┴─────┴─────┘