Wins - A: 2 | B: 2
Days: 1   Record: 14


┌─────┬─────┬─────┬─────┬─────┐
│  A  │  A  │  B  │  B  │  B  │
├─────┼─────┼─────┼─────┼─────┤
│  A  │  A  │  A  │  B  │  B  │
├─────┼─────┼─────┼─────┼─────┤
│  A  │  A  │  A  │  B  │  B  │
├─────┼─────┼─────┼─────┼─────┤
│  A  │  A  │  B  │  B  │  B  │
├─────┼─────┼─────┼─────┼─────┤
│  A  │  A  │  B  │  B  │  B  │
├─────┼─────┼─────┼─────┼─────┤
│  A  │  A  │  B  │  B  │  B  │
└─────┴─────┴─────┴─────┴─────┘