Wins - A: 2 | B: 2
Days: 5   Record: 14


┌─────┬─────┬─────┬─────┬─────┐
│  A  │  A  │  B  │  B  │  B  │
├─────┼─────┼─────┼─────┼─────┤
│  A  │  A  │  A  │  A  │  B  │
├─────┼─────┼─────┼─────┼─────┤
│  A  │  A  │  A  │  A  │  B  │
├─────┼─────┼─────┼─────┼─────┤
│  B  │  B  │  B  │  B  │  B  │
├─────┼─────┼─────┼─────┼─────┤
│  A  │  A  │  B  │  B  │  B  │
├─────┼─────┼─────┼─────┼─────┤
│  A  │  A  │  B  │  B  │  B  │
└─────┴─────┴─────┴─────┴─────┘