Wins - A: 2 | B: 3
Days: 4   Record: 14


┌─────┬─────┬─────┬─────┬─────┐
│  A  │  A  │  A  │  B  │  B  │
├─────┼─────┼─────┼─────┼─────┤
│  A  │  A  │  A  │  A  │  A  │
├─────┼─────┼─────┼─────┼─────┤
│  A  │  A  │  A  │  B  │  B  │
├─────┼─────┼─────┼─────┼─────┤
│  A  │  A  │  B  │  B  │  B  │
├─────┼─────┼─────┼─────┼─────┤
│  A  │  A  │  B  │  B  │  B  │
├─────┼─────┼─────┼─────┼─────┤
│  A  │  A  │  B  │  B  │  B  │
└─────┴─────┴─────┴─────┴─────┘